*..*..*...*.....*...
..*.....*...*....*..
.*...E*.*........*..
.........*..*.......
**...*.*...*...*...*
..*.*.....*........*
*..*..*..*.....*....
*.*.*.....*.........
....*..*..*..*...*..
..*......*.*....*.*.
*..*...*..*....*....
..*.*......*.......*
......*........*....
...*......*...*....*
..*...*....*....*...
..*................*
......*......*.*....
*.*......*....*.....
..*...*..*.....*...*
......*......^..*...