.*........
*...*.....
..*.......
...E*..*..
..........
.*....*.*.
.....*..^.
...*......
........*.
..**...*.*