*..*..*...*.....*...
..*.....*...*....*..
.*...E...........*..
.........*..*.......
**...*.*...*...*...*
..*.*.....*........*
*..*..*..*.....*....
..*...*....*....*...
..*................*
......*........*....
*.*......*....*.....
..*...*..*.....*...*
......*......^..*...